w w w w w p p p p p w w w w s
w p s w w p p p p p w s w w w
w w w w w p p p p p w w c w w
w w c w w p p p p p w w w w w
w w w w w p p p p p w p w w w
w w p w w p p p p p w w c w w
w w s w w p p p p p w w w w w
w w p w w p p w p p w w s o o
w c w w w p p s p p w w o o o
w w w w w p p p p p w w w o o
w s w s w p p s p p w w w w w
w w w w w p p p p p w w c w w
w w w w w p w p p p w w w w w
w w w p w p p p p p w w s w w
w c w w w p p p w p w w w w w
w w w w w p p p p p w w w w w
w s w w w p p p p p w w w w w
w w w w w p p p p p w w w w w