o o o o s s s s s s
o o o o o o o o s s
o o o o s s o s s s
s o s s s s o s s s
s s s s s s s s s s
o o o s s s o o s s
o o s s s o o o s s